####################
#                 F#
#  #################
#  E              C#
###########    #####
#             N   C#
##  ################
#C                 #
###### ####  #######
#                  #
#CC #NS########    #
#                  #
################   #
#P                C#
####################